ZZZZZZZZZZZZZZZZZZZZZZZZZZZZZZZZZZZZZZZZZZZZZZZZZZZZZZZZZZZZZZZH
ZZZZZZZZZZZZZZZZZZZZZZZZZZZZZZZZZZZZZZZZZZZZZZZZZZZZZZZZZZZZZZZH
ZZZZZZZZZZZZZZZZZZZZZZZZZZZZZZZZZZZZZZZZZZZZZZZZZZZZZZZZZZZZZZZH
ZZZZZZZZZZZZZZZZZZZZZZZZZZZZZZZZZZZZZZZZZZZZZZZZZZZZZZZZZZZZZZZH
ZZZZZZZZZZZZZZZZZZZZZZZZZZZZZZZZZZZZZZZZZZZZZZZZZZZZZZZZZZZZZZZH
ZZZZZZZZZZZZZZZZZZZZZZZZZZZZZZZZZZZZZZZZZZZZZZZZZZZZZZZZZZZZZZZH
ZZZZZZZZZZZZZZZZZZZZZZZZZZZZZZZZZZZZZZZZZZZZZZZZZZZZZZZZZZZZZZZH
ZZZZZZZZZZZZZZZZZZZZZZZZZZZZZZZZZZZZZZZZJKIIZZZZZZZZZZZZZZZZZZZH
ZZZZZZZZZZZZZZZZZZZZZZZZZZZZZZIKJZZZZZIKZZZZKZZZZZZZZZZZZZZZZZZH
ZZZZZZZZZZZZZZZZZZZZZZZZZZZZZZZZZKKIJKZZZZZZZJJIKIZZZZZZZZZZZZZH
IJIKKZZZZZZZZZZZZZZZZZZZZZZZZZZZZZZZZZZZZZZZZZZZZZKIIZZZZZZZZZZH
ZZZZZIJKZZZZZZZZZZZZZZZZZZZZZZZZZZZZZZZZZZZZZZZZZZZZZJZZZZZZZZZH
ZZZZZZZZJKKJIZZZZZZZZZZZZZZZZZZZZZZZZZZZZZZZZZZZZZZZZZZZZZZZZZZH
ZZZZZZZZZZZZZIZZZZZZZZZZZZZZZZZZZZZZZZZZZZZZZZZZZZZZZZZZZZZZZZZH
ZZZZZZZZZZZZZZIKZZZZZZZZZZZZIKJZZZZZZZZZZZZZZZZZZZZZZZZZZZZZJKKH
ZZZZZZZZZZZZZZZZJIIZZZZZIKJKZZZZZZZZZZZZZZZZZZZZZZZZZZJJIKKIZZZH
ZZZZZZZZZZZZZZZZZZZIKJJKZZZZZZZZZZZZZZZZZZZZZZZZZZZZKIZZZZZZZZZH
ZZZZZZZZZZZZZZZZZZZZZZZZZZZZZZZZZZZZZZZZZZZZZZZZZZZKZZZZZZZZZZZH
ZZZZZZZZZZZZZZZZZZZZZZZZZZZZZZZZZZZZZZZZZZZZZZZZKJIZZZZZZZZZZZZH
ZZZZZZZZZZZZZZZZZZZZZZZZZZZZZZZZZZZZZZZZZZZZZKIJZZZZZZZZZZZZZZZH
ZZZZZZZZZZZZZZZZZZZZZZZZZZZZZZZZZZZZZZZZZZZZKZZZZZZZZZZZZZZZZZZH
ZZZZZZZZZZZZZZZZZZZZZZZZZZZZZZZZZZZZZZZZKKJJZZZZZZZZZZZZZZZZZZZZ
ZZZZZZZZZZZZZZZZZZZZZZZZZZZIIZZZZZZZZZJIZZZZZZZZZZZZZZZZZZZZZZZZ
ZZZZZZZZZZZZZZZZZZZZZZZZZZZZZKJIJJKIIKZZZZZZZZZZZZZZZZZZZZZZZZZZ

b1 600 400
b2 800 400
tu 400 800
r 800 800
tb 1000 600
tm 1000 414
