ZZZZZZZZZZZZZZZZZZZZZZZZZZZZZZZZZZZZZZZZZZZZZZZZZZZZZZZZZZZZZZZH
ZZZZZZZZZZZZZZZZZZZZZZZZZZZZZZZZZZZZZZZZZZZZZZZZZZZZZZZZZZZZZZZH
ZZZZZZZZZZZZZZZZZZZZZZZZZZZZZZZZZZZZZZZZZZZZZZZZZZZZZZZZZZZZZZZH
ZZZZZZZZZZZZZZZZZZZZZZZZZZZZZZZZZZZZZZZZZZZZZZZZZZZZZZZZZZZZZZZH
ZZZZZZZZZZZZZZZZZZZZZZZZZZZZZZZZZZZZZZZZZZZZZZZZZZZZZZZZZZZZZZZH
ZZZZZZZZZZZZZZZZZZZZZZZZZZZZZZZZZZZZZZZZZZZZZZZZZZZZZZZZZZZZZZZH
ZZZZZZZZZZZZZZZZZZZZZZZZZZZZZZZZZZZZZZZZZZZZZZZZZZZZZZZZZZZZZZZH
ZZZZZZZZZZZZZZZZZZZZZZZZZZZZZZZZZZZZZZZZJKIIZZZZZZZZZZZZZZZZZZZH
ZZZZZZZZZZZZZZZZZZZZZZZZZZZZZZIKJZZZZZIKLLLLKZZZZZZZZZZZZZZZZZZH
ZZZZZZZZZZZZZZZZZZZZZZZZZZZZZZZLLKKIJKLLLLLLLJJIKIZZZZZZZZZZZZZH
IJIKKZZZZZZZZZZZZZZZZZZZZZZZZZZZZZZZZZZZZZZZLLLLLLKIIZZZZZZZZZZH
LLLLLIJKZZZZZZZZZZZZZZZZZZZZZZZZZZZZZZZZZZZZLLLLLLLLLJZZZZZZZZZH
LLLLLLLLJKKJIZZZZZZZZZZZZZZZZZZZZZZZZZZZZZZZZZZZZZZZZZZZZZZZZZZH
LLLLLLLLLLLLLIZZZZZZZZZZZZZZZZZZZZZZZZZZZZZZZZZZZZZZZZZZZZZZZZZH
LLLLLLLLLLLLLLIKZZZZZZZZZZZZIKJZZZZZZZZZZZZZZZZZZZZZZZZZZZZZJKKH
LLLLLLLLLLLLLLLLJIIZZZZZIKJKLLZZZZZZZZZZZZZZZZZZZZZZZZJJIKKILLLH
LLLLLLLLLLLLLLLLLLLIKJJKLLLLLLZZZZZZZZZZZZZZZZZZZZZZKILLLLLLLLLH
LLLLLLLLLLLLLLLLLLLLLLLLLLLLLZZZZZZZZZZZZZZZZZZZZZZKLLLLLLLLLLLH
LLLLLLLLLLLLLLLLLLLLLLLLLLLLZZZZZZZZZZZZZZZZZZZZKJILLLLLLLLLLLLH
LLLLLLLLLLLLLLLLLLLLLLLLLLLLZZZZZZZZZZZZZZZZZKIJLLLLLLLLLLLLLLLH
LLLLLLLLLLLLLLLLLLLLLLLLLLLZZZZZZZZZZZZZZZZZKLLLLLLLLLLLLLLLLLLH
LLLLLLLLLLLLLLLLLLLLLLLLLLZZZZZZZZZZZZZZKKJJLLLLLLLLLLLLLLLLLLLL
LLLLLLLLLLLLLLLLLLLLLLLLLLLIIZZZZZZZZZJILLLLLLLLLLLLLLLLLLLLLLLL
LLLLLLLLLLLLLLLLLLLLLLLLLLLLLKJIJJKIIKLLLLLLLLLLLLLLLLLLLLLLLLLL
LLLLLLLLLLLLLLLLLLLLLLLLLLLLLLLLLLLLLLLLLLLLLLLLLLLLLLLLLLLLLLLL
LLLLLLLLLLLLLLLLLLLLLLLLLLLLLLLLLLLLLLLLLLLLLLLLLLLLLLLLLLLLLLLL

b2 2541 712
tu 534 1002
r 987 1152
r 1075 1152
b2 1432 1110
b1 1780 875
b2 2033 594
b1 2421 508
b1 2749 494
b2 3041 631
b1 3065 235
b1 3501 420
b2 3783 377
b1 3640 229
b1 4124 548
b1 4409 561
b2 4571 460
tb 2093 1511
tm 2110 1348
tm 2118 1184
r 2452 1700
b1 2614 1531
b2 2806 1403
b2 3477 1187
b1 4208 996
b2 4077 871
r 1893 1095
tu 3161 1547
r 3530 1393
r 4080 1095
r 3764 723
r 3494 645
tu 2916 572
