HHHHHHHHHHHHHHHHHHHHHHHHHHHHHHHHHHHHHHHHHHHHHHHHHHH
H1111111111111111111111111111111111111111111111111H
HEEEEEEEEEEEEEEEEEEEEEEEEEEEEEEEEEEEEEEEEEEEEEEEEEH
HEEEE2EEEEEEEEGEEEEEEEE2EEEEEE2EEEEEEEEGEEEEEEEE2EH
HEEEEEEEEEFEEEEEEEEEEFEEEEEEEEEEEEEFEEEEEEEEEEFEEEH
H4E79BBBEEEE4EC9BBB0E4E7CE4E79BBBEEEE4EC9BBB0E4E7CH
H3E68AAA66663668AAA66366663668AAA66663668AAA663E66H
H1E1111111111111111111111H111111111111111111111E11H
HEEEEEEEEEEEEEEEEEEEEEEEEHEEEEEEEEEEEEEEEEEEEEEEEEH
HEEEEEEEGEEEEFFEEEEEEEEEEHEEEEEEEGEEEEFFEEEEEEEEEEH
HEEEEEEEEEEEEFFEEEEE2EEEEHEEEEEEEEEEEEFFEEEEE2EEEEH
H4EBBBE7E0E4EEECEBBEE04E7H4EBBBE7E0E4EEECEBBEE04E7H
H36AAA6666636E666AA666366H36AAA66E66366566AA666366H
H111111111111E11111111111H1111111E1111111111111111H
HEEEEEEEEEEEEEEEEEEEEEEEEHEEEEEEEEEEEEEEEEEEEEEEEEH
HEEEEEEE2EEEEGEEFFFFEEEEEHEEEEEEE2EEEEGEEFFFFEEEEEH
HEEEEEEEEEEEEEEEFFFFE07EEHEEEEEEEEEEEEEEEFFFFE07EEH
HE4EC9BBBE07EBBEEEEEEBBE4HE4EC9BBBE07EBBEEEEEEBBE4H
H63668AAA6566AA656665AA63H63658AAA6566AA655665AA63H
HHHHHHHHHHHHHHHHHHHHHHHHHHHHHHHHHHHHHHHHHHHHHHHHHHH

h1 1230 1080
h3 1000 1080
t 500 1444
p 830 1415
t 1650 1444
h2 1810 1080
h1 2004 1080
h1 354 600
h3 542 600
p 620 940
h2 746 600
h2 1055 600
t 1114 965
p 713 415
h3 887 116
h1 1398 116
h3 1210 116
t 1398 450
p 1911 416
h1 2121 116
t 2556 452
h3 2391 116
h2 2665 115
h1 2902 115
p 3362 420
h1 3140 115
h3 3619 115
h2 3621 565
p 3080 868
h3 2888 564
h2 2623 566
t 2336 903
h1 2429 566
h2 2461 1016
h3 2218 1016
p 2712 1318
p 3003 1318
h3 3194 1015
h1 3430 1015
t 3464 1352
